1 13 31
###############################
#p     ** *2   *   *  * * *   #
# # # #*# # #*#*# # # #*#*#*# #
#   *     ***  *      *   * * #
# # # # # #*# # #*#*# # # # #*#
#f         x **1 *  *  1     1#
# # # # # # # # # #*#1#*# # # #
#*  *      *  *      *        #
# # # # #*# # # #*#*# # # # # #
#*    **  *       *    5      #
# #*# # # # # # #*# # # # # # #
#           *1  *  *          #
###############################