1 13 31
###############################
#p     ** *    *   *  * * *   #
# # # #*# # #*#*# # # #*#*#*# #
#   * s   ***  *      *   * * #
# # # # # #*# # #*#*# # # # #*#
#f    b    x **1 *  *  1     1#
# # # # # # # # # #*#1#*# # # #
#*  *      *  *      *        #
# # # # #*# # # #*#*# # # # # #
#*    **  *       *           #
# #*# # # # # # #*# # # # # # #
#           *1  *  *          #
###############################